11111111111111111111
1000C001100000000001
10C10110101110000001
100100C0001P000000E1
10001100011110000001
11111111111111111111
