11111111111111111111
1000C001100000000001
10C10110101111000001
100100C00001PE000001
10001100011111000001
11111111111111111111
