11111111111111111111
1000C001100000000001
10C10110101110000001
100100C000EP00000001
10001100011110000001
11111111111111111111
