11111111111111111111111
10101C10101010101010101
100000000000000000E0001
11010010101011010101101
1C00000000P000000000001
10101010101001011010111
10000000000000000C00001
11111111111111111111111