11111111111111111111111
10101C10101010101010101
100000000000000001E0001
10101010101010101010101
1C000000000000000000001
10111110101010101010101
100001P0000000000C00001
11111111111111111111111