11111111111111111111111111111111111
100000000000010000EC000000000000001
10000000000001000000000000000000001
10000000000001000000000000000000001
10000000000001000000000000000000001
10000000000001000000000000000000001
10000000000001000000000000000000001
10000C00000001000000000000000000001
10000000000001000000000000000000001
10000000000001000000000000000000001
10000000000000000000000000000000001
1111111111111P111111111111111111111
10000000000001000000000000000000001
10000000000001000000000000000000001
10000000000001000000000000000000001
10000000000001000000000000000000001
10000000000001000000000000000000001
10000000000001000000000000000000001
10000000000001000000000000000000001
11111111111111111111111111111111111