11111111111111111111111
1000000000C010000000001
10010010001000111100001
10C10011111111100000001
10100010001000000E01111
10111110100011111000001
1C10P00010001C000000001
11111111111111111111111