11111111111111111111111
1000000000C010000000001
10010010001000111100001
10C10011111111100000001
101000100010000P1E01111
11101010100011111000001
1C10000010001C000000001
11111111111111111111111