11111111111111111111111
1C0000000010110000000E1
10000000111011100000001
10000000000P00000000001
10000000111011100000001
10000000001010000000001
1C000000001C10000000001
11111111111111111111111