111111111111111
1000C0E11000001
10C101101011101
100100C0001P001
111111111111111
