1111111111
1000C0EP01
100C000001
1111111111
