111111111111111
1000C0E01000001
100C00001011101
100100C0001P001
111111111111111
