11111111111111111111111
1000C001100000000000001
10C10110101110000000001
100100C0001P000000E0001
10001100011110000000001
10000000000000000000001
11111111111111111111111
